(no author) = (no author) <(no author)>
aadamchik = aadamchik <aadamchik>
aaron = aaron <aaron>
abayer = abayer <abayer>
abroekhuis = abroekhuis <abroekhuis>
abrookes = abrookes <abrookes>
aching = aching <aching>
acmurthy = acmurthy <acmurthy>
adc = adc <adc>
adina = adina <adina>
afchung90 = afchung90 <afchung90>
ahart = ahart <ahart>
aharui = aharui <aharui>
ajack = ajack <ajack>
ajborley = ajborley <ajborley>
akarasulu = akarasulu <akarasulu>
aldrin = aldrin <aldrin>
amareshwari = amareshwari <amareshwari>
andrew = andrew <andrew>
andrewp = andrewp <andrewp>
andy = andy <andy>
andyc = andyc <andyc>
andyp = andyp <andyp>
anew = anew <anew>
antelder = antelder <antelder>
antoine = antoine <antoine>
aprateek = aprateek <aprateek>
apurtell = apurtell <apurtell>
aroush = aroush <aroush>
arvind = arvind <arvind>
asanso = asanso <asanso>
asavory = asavory <asavory>
asavu = asavu <asavu>
asrabkin = asrabkin <asrabkin>
asuresh = asuresh <asuresh>
ate = ate <ate>
atri = atri <atri>
autayeu = autayeu <autayeu>
azeez = azeez <azeez>
bayard = bayard <bayard>
bbende = bbende <bbende>
bdelacretaz = bdelacretaz <bdelacretaz>
bdudney = bdudney <bdudney>
bendewey = bendewey <bendewey>
benh = benh <benh>
berndf = berndf <berndf>
bigbluehat = bigbluehat <bigbluehat>
billgraham = billgraham <billgraham>
billie = billie <billie>
bimargulies = bimargulies <bimargulies>
blautenb = blautenb <blautenb>
bluk = bluk <bluk>
bodewig = bodewig <bodewig>
bommel = bommel <bommel>
brane = brane <brane>
brentlintner = brentlintner <brentlintner>
brett = brett <brett>
brianf = brianf <brianf>
brianleroux = brianleroux <brianleroux>
brianm = brianm <brianm>
brondsem = brondsem <brondsem>
bryanduxbury = bryanduxbury <bryanduxbury>
bsnyder = bsnyder <bsnyder>
busbey = busbey <busbey>
bzz = bzz <bzz>
carnold = carnold <carnold>
cazen = cazen <cazen>
cctrieloff = cctrieloff <cctrieloff>
cdouglas = cdouglas <cdouglas>
ceki = ceki <ceki>
chenpei = chenpei <chenpei>
chipchilders = chipchilders <chipchilders>
chipsenkbeil = chipsenkbeil <chipsenkbeil>
chirino = chirino <chirino>
chl501 = chl501 <chl501>
chobrian = chobrian <chobrian>
chtyim = chtyim <chtyim>
cliffs = cliffs <cliffs>
clr = clr <clr>
cmarcum = cmarcum <cmarcum>
coar = coar <coar>
coreyg = coreyg <coreyg>
cos = cos <cos>
covener = covener <covener>
craigmcc = craigmcc <craigmcc>
criccomini = criccomini <criccomini>
crossley = crossley <crossley>
curcuru = curcuru <curcuru>
cutting = cutting <cutting>
cziegeler = cziegeler <cziegeler>
daijy = daijy <daijy>
dain = dain <dain>
damien = damien <damien>
danbress = danbress <danbress>
danhaywood = danhaywood <danhaywood>
danielsh = danielsh <danielsh>
dansilivestru = dansilivestru <dansilivestru>
dashorst = dashorst <dashorst>
davidw = davidw <davidw>
dblevins = dblevins <dblevins>
ddas = ddas <ddas>
ddekany = ddekany <ddekany>
dferro = dferro <dferro>
dhruv = dhruv <dhruv>
dima = dima <dima>
dims = dims <dims>
dinhtta = dinhtta <dinhtta>
dixson = dixson <dixson>
djencks = djencks <djencks>
dkulp = dkulp <dkulp>
doebele = doebele <doebele>
dortef = dortef <dortef>
dreid = dreid <dreid>
drew = drew <drew>
dwoods = dwoods <dwoods>
eawilliams = eawilliams <eawilliams>
edwardyoon = edwardyoon <edwardyoon>
eevans = eevans <eevans>
egli = egli <egli>
ehatcher = ehatcher <ehatcher>
ekoneil = ekoneil <ekoneil>
elecharny = elecharny <elecharny>
elib = elib <elib>
elserj = elserj <elserj>
ericjohnson = ericjohnson <ericjohnson>
esammer = esammer <esammer>
etnu = etnu <etnu>
eyang = eyang <eyang>
fapeeler = fapeeler <fapeeler>
faridz = faridz <faridz>
farra = farra <farra>
fchrist = fchrist <fchrist>
fegaras = fegaras <fegaras>
felixcheung = felixcheung <felixcheung>
fielding = fielding <fielding>
filmaj = filmaj <filmaj>
fitzner = fitzner <fitzner>
florianh = florianh <florianh>
fmeschbe = fmeschbe <fmeschbe>
fmui = fmui <fmui>
fpj = fpj <fpj>
francisdb = francisdb <francisdb>
garyh = garyh <garyh>
garyw = garyw <garyw>
gates = gates <gates>
gaul = gaul <gaul>
geirm = geirm <geirm>
geoff = geoff <geoff>
gerdogdu = gerdogdu <gerdogdu>
gjm = gjm <gjm>
gmcdonald = gmcdonald <gmcdonald>
gnaylor = gnaylor <gnaylor>
gnodet = gnodet <gnodet>
gourksaha = gourksaha <gourksaha>
greddin = greddin <greddin>
gregor = gregor <gregor>
greid = greid <greid>
grobmeier = grobmeier <grobmeier>
gsingers = gsingers <gsingers>
gstein = gstein <gstein>
gwkim = gwkim <gwkim>
gwynevans = gwynevans <gwynevans>
hadrian = hadrian <hadrian>
hammant = hammant <hammant>
hao = hao <hao>
hashutosh = hashutosh <hashutosh>
hboutemy = hboutemy <hboutemy>
heathers = heathers <heathers>
henning = henning <henning>
henry = henry <henry>
hibou = hibou <hibou>
hitesh = hitesh <hitesh>
hlship = hlship <hlship>
hogstrom = hogstrom <hogstrom>
hossman = hossman <hossman>
hsaputra = hsaputra <hsaputra>
hughesj = hughesj <hughesj>
humbedooh = humbedooh <humbedooh>
husted = husted <husted>
hyunsik = hyunsik <hyunsik>
hzeller = hzeller <hzeller>
ianh = ianh <ianh>
ianwdunlop = ianwdunlop <ianwdunlop>
ilgrosso = ilgrosso <ilgrosso>
ips = ips <ips>
isabel = isabel <isabel>
jacopoc = jacopoc <jacopoc>
jakob = jakob <jakob>
jakobk = jakobk <jakobk>
jalkanen = jalkanen <jalkanen>
james-masanz = james-masanz <james-masanz>
jamesbognar = jamesbognar <jamesbognar>
jamestaylor = jamestaylor <jamestaylor>
jan = jan <jan>
jani = jani <jani>
jarcec = jarcec <jarcec>
jbapple = jbapple <jbapple>
jbonofre = jbonofre <jbonofre>
jboynes = jboynes <jboynes>
jdonofrio = jdonofrio <jdonofrio>
jefft = jefft <jefft>
jeremias = jeremias <jeremias>
jerenkrantz = jerenkrantz <jerenkrantz>
jerry = jerry <jerry>
jfarrell = jfarrell <jfarrell>
jfclere = jfclere <jfclere>
jfthomps = jfthomps <jfthomps>
jghoman = jghoman <jghoman>
jhyde = jhyde <jhyde>
jim = jim <jim>
jitendra = jitendra <jitendra>
jjkoshy = jjkoshy <jjkoshy>
jkaputin = jkaputin <jkaputin>
jkosin = jkosin <jkosin>
jlboudart = jlboudart <jlboudart>
jlk = jlk <jlk>
jm = jm <jm>
jmacna = jmacna <jmacna>
jmclean = jmclean <jmclean>
jmsnell = jmsnell <jmsnell>
jochen = jochen <jochen>
joern = joern <joern>
joes = joes <joes>
joewitt = joewitt <joewitt>
johndament = johndament <johndament>
johnsca = johnsca <johnsca>
joyce = joyce <joyce>
jstrachan = jstrachan <jstrachan>
jta = jta <jta>
juanpablo = juanpablo <juanpablo>
jukka = jukka <jukka>
jvanzyl = jvanzyl <jvanzyl>
jwills = jwills <jwills>
jzb = jzb <jzb>
kaosko = kaosko <kaosko>
karpet = karpet <karpet>
kaspersor = kaspersor <kaspersor>
ke4qqq = ke4qqq <ke4qqq>
kevan = kevan <kevan>
kishoreg = kishoreg <kishoreg>
kmarsden = kmarsden <kmarsden>
kminder = kminder <kminder>
kschenk = kschenk <kschenk>
kwright = kwright <kwright>
lahiru = lahiru <lahiru>
lakmal = lakmal <lakmal>
lehmi = lehmi <lehmi>
leosimons = leosimons <leosimons>
lewismc = lewismc <lewismc>
lhazlewood = lhazlewood <lhazlewood>
lindner = lindner <lindner>
lmandel = lmandel <lmandel>
logie = logie <logie>
lresende = lresende <lresende>
lukehan = lukehan <lukehan>
lutter = lutter <lutter>
mabowen = mabowen <mabowen>
mafr = mafr <mafr>
mahadev = mahadev <mahadev>
manolito = manolito <manolito>
marcus = marcus <marcus>
mark = mark <mark>
markt = markt <markt>
marrs = marrs <marrs>
martinc = martinc <martinc>
marvin = marvin <marvin>
matei = matei <matei>
mattmann = mattmann <mattmann>
matzew = matzew <matzew>
mbenson = mbenson <mbenson>
mcslee = mcslee <mcslee>
me = me <me>
metskem = metskem <metskem>
mfranklin = mfranklin <mfranklin>
michael = michael <michael>
milamber = milamber <milamber>
minalee = minalee <minalee>
mmarinschek = mmarinschek <mmarinschek>
mmiklavcic = mmiklavcic <mmiklavcic>
mmorel = mmorel <mmorel>
mnour = mnour <mnour>
mnuttall = mnuttall <mnuttall>
monteith = monteith <monteith>
moon = moon <moon>
mostarda = mostarda <mostarda>
mpoole = mpoole <mpoole>
mrdon = mrdon <mrdon>
mriou = mriou <mriou>
mryan3 = mryan3 <mryan3>
mvdb = mvdb <mvdb>
mw = mw <mw>
mwomack = mwomack <mwomack>
myoder = myoder <myoder>
ngallardo = ngallardo <ngallardo>
niallp = niallp <niallp>
nick = nick <nick>
nickchalko = nickchalko <nickchalko>
niclas = niclas <niclas>
nicolaken = nicolaken <nicolaken>
niq = niq <niq>
noel = noel <noel>
nslater = nslater <nslater>
oching = oching <oching>
olamy = olamy <olamy>
olga = olga <olga>
olira = olira <olira>
omalley = omalley <omalley>
orcmid = orcmid <orcmid>
oschaaf = oschaaf <oschaaf>
pascalschumacher = pascalschumacher <pascalschumacher>
paulk = paulk <paulk>
pctony = pctony <pctony>
phunt = phunt <phunt>
pkluegl = pkluegl <pkluegl>
pono = pono <pono>
pquerna = pquerna <pquerna>
prabhjyotsingh = prabhjyotsingh <prabhjyotsingh>
pramod = pramod <pramod>
prasadm = prasadm <prasadm>
psharples = psharples <psharples>
psteitz = psteitz <psteitz>
ptgoetz = ptgoetz <ptgoetz>
pwendell = pwendell <pwendell>
pzf = pzf <pzf>
rajith = rajith <rajith>
rana_b = rana_b <rana_b>
randgalt = randgalt <randgalt>
raphael = raphael <raphael>
rbowen = rbowen <rbowen>
rdonkin = rdonkin <rdonkin>
rec = rec <rec>
recordond = recordond <recordond>
reiher = reiher <reiher>
reto = reto <reto>
rfrovarp = rfrovarp <rfrovarp>
rgardler = rgardler <rgardler>
rhirsch = rhirsch <rhirsch>
richard = richard <richard>
rickhall = rickhall <rickhall>
rjollos = rjollos <rjollos>
rkins = rkins <rkins>
rmannibucau = rmannibucau <rmannibucau>
rmarton = rmarton <rmarton>
rmetzger = rmetzger <rmetzger>
rmuir = rmuir <rmuir>
rnewson = rnewson <rnewson>
robbie = robbie <robbie>
robweir = robweir <robweir>
roku = roku <roku>
rolandw = rolandw <rolandw>
rooneg = rooneg <rooneg>
rsharma = rsharma <rsharma>
rubys = rubys <rubys>
rvesse = rvesse <rvesse>
rvs = rvs <rvs>
rwaldhoff = rwaldhoff <rwaldhoff>
sabob = sabob <sabob>
salyh = salyh <salyh>
sanand = sanand <sanand>
sanjiva = sanjiva <sanjiva>
sarowe = sarowe <sarowe>
scamp = scamp <scamp>
sccomer = sccomer <sccomer>
schor = schor <schor>
scottbw = scottbw <scottbw>
sctemme = sctemme <sctemme>
sdp = sdp <sdp>
sebawagner = sebawagner <sebawagner>
sebb = sebb <sebb>
sebgoa = sebgoa <sebgoa>
sebor = sebor <sebor>
seelmann = seelmann <seelmann>
shanti = shanti <shanti>
shazron = shazron <shazron>
shreepadma = shreepadma <shreepadma>
shwethags = shwethags <shwethags>
sijie = sijie <sijie>
sijskes = sijskes <sijskes>
simonetripodi = simonetripodi <simonetripodi>
simonw = simonw <simonw>
sisbell = sisbell <sisbell>
smarru = smarru <smarru>
smarthi = smarthi <smarthi>
sneethir = sneethir <sneethir>
snoopdave = snoopdave <snoopdave>
solomax = solomax <solomax>
sorber = sorber <sorber>
spmallette = spmallette <spmallette>
sravya = sravya <sravya>
sriksun = sriksun <sriksun>
sseth = sseth <sseth>
stack = stack <stack>
stain = stain <stain>
stevel = stevel <stevel>
steven = steven <steven>
stoddard = stoddard <stoddard>
striker = striker <striker>
stroucki = stroucki <stroucki>
struberg = struberg <struberg>
sureshs = sureshs <sureshs>
svanteschubert = svanteschubert <svanteschubert>
svarnau = svarnau <svarnau>
sviens = sviens <sviens>
sylvain = sylvain <sylvain>
taegeonum = taegeonum <taegeonum>
taylor = taylor <taylor>
tcurdt = tcurdt <tcurdt>
tdunning = tdunning <tdunning>
tellison = tellison <tellison>
tfischer = tfischer <tfischer>
thejas = thejas <thejas>
thobbs = thobbs <thobbs>
thorsten = thorsten <thorsten>
thw = thw <thw>
tillw = tillw <tillw>
tmnk = tmnk <tmnk>
todd = todd <todd>
tomaz = tomaz <tomaz>
tommaso = tommaso <tommaso>
tommatecki = tommatecki <tommatecki>
tomwhite = tomwhite <tomwhite>
tripod = tripod <tripod>
trustin = trustin <trustin>
tucu = tucu <tucu>
tvolkert = tvolkert <tvolkert>
twgoetz = twgoetz <twgoetz>
twilliams = twilliams <twilliams>
twl = twl <twl>
umamahesh = umamahesh <umamahesh>
upayavira = upayavira <upayavira>
veithm = veithm <veithm>
venkatesh = venkatesh <venkatesh>
vsiveton = vsiveton <vsiveton>
wikier = wikier <wikier>
woodser = woodser <woodser>
wrowe = wrowe <wrowe>
wsmoak = wsmoak <wsmoak>
yanpingw = yanpingw <yanpingw>
yoavs = yoavs <yoavs>
yonik = yonik <yonik>
yonzhang2012 = yonzhang2012 <yonzhang2012>
yusaku = yusaku <yusaku>
zwoop = zwoop <zwoop>
